0000000000000
0100000000010
0100000000010
0100000000010
0100000000010
0100011100010
0100011100010
0100000000010
0101100011010
0100000000010
0100000000010
0100000000010
0000000000000
